###################################
# Syntax Coloring Map for Pixie
###################################

###################################
# Datatypes (KEYWORD1)
###################################

Pixie	KEYWORD1

###################################
# Methods and Functions (KEYWORD2)
###################################

begin	KEYWORD2
flipped	KEYWORD2
show	KEYWORD2
brightness	KEYWORD2
clear	KEYWORD2
write_char	KEYWORD2
write	KEYWORD2
print_char	KEYWORD2
print	KEYWORD2
push_char	KEYWORD2
push_byte	KEYWORD2
push	KEYWORD2
shift_char	KEYWORD2
shift_byte	KEYWORD2
shift	KEYWORD2
draw_line	KEYWORD2
get_length	KEYWORD2
scroll_message	KEYWORD2
set_pix	KEYWORD2
dump_buffer	KEYWORD2
reset	KEYWORD2

###################################
# Constants (LITERAL1)
###################################

PIX_ARROW_UP	LITERAL1
PIX_ARROW_UP_LEFT	LITERAL1
PIX_ARROW_UP_RIGHT	LITERAL1
PIX_ARROW_DOWN	LITERAL1
PIX_ARROW_DOWN_LEFT	LITERAL1
PIX_ARROW_DOWN_RIGHT	LITERAL1
PIX_ARROW_LEFT	LITERAL1
PIX_ARROW_RIGHT	LITERAL1
PIX_UNDO	LITERAL1
PIX_REDO	LITERAL1
PIX_REFRESH	LITERAL1
PIX_TRIANGLE_UP	LITERAL1
PIX_TRIANGLE_DOWN	LITERAL1

PIX_HEART	LITERAL1
PIX_SMILE	LITERAL1
PIX_FROWN	LITERAL1
PIX_HAPPY	LITERAL1
PIX_SAD	LITERAL1
PIX_ANGRY	LITERAL1
PIX_NO	LITERAL1
PIX_DO_NOT_ENTER	LITERAL1
PIX_MAIL	LITERAL1
PIX_PHONE_CALL	LITERAL1
PIX_WIRELESS	LITERAL1
PIX_X_OUT	LITERAL1
PIX_CROSS	LITERAL1
PIX_MEDIC_CROSS	LITERAL1
PIX_SQUARE	LITERAL1
PIX_TRIANGLE	LITERAL1
PIX_CIRCLE	LITERAL1
PIX_RECTANGLE	LITERAL1
PIX_EXPORT	LITERAL1
PIX_SAVE	LITERAL1
PIX_CLOCK	LITERAL1
PIX_STOPWATCH	LITERAL1
PIX_TV	LITERAL1
PIX_COPY	LITERAL1
PIX_DOCUMENT	LITERAL1
PIX_SMARTPHONE	LITERAL1
PIX_BLUETOOTH	LITERAL1
PIX_GPS_PIN	LITERAL1
PIX_STOCKS	LITERAL1
PIX_HOUSE	LITERAL1
PIX_FLOWER	LITERAL1
PIX_MUSIC_NOTE	LITERAL1
PIX_USB	LITERAL1
PIX_MAGNIFYING_GLASS	LITERAL1
PIX_POWER	LITERAL1
PIX_CONTACT	LITERAL1
PIX_CALENDAR	LITERAL1
PIX_WRENCH	LITERAL1
PIX_POISON	LITERAL1
PIX_GAS	LITERAL1
PIX_TARGET	LITERAL1
PIX_MALE	LITERAL1
PIX_FEMALE	LITERAL1
PIX_RIBBON	LITERAL1
PIX_CAT	LITERAL1
PIX_BONE	LITERAL1
PIX_EVIL_CORP	LITERAL1
PIX_RUDE	LITERAL1
PIX_PADLOCK	LITERAL1
PIX_NFC	LITERAL1
PIX_SYNC	LITERAL1
PIX_INFO	LITERAL1

PIX_OHM	LITERAL1
PIX_ELECTRIC	LITERAL1
PIX_ANTENNA	LITERAL1
PIX_RESISTOR_US	LITERAL1
PIX_RESISTOR_EU	LITERAL1
PIX_CAPACITOR	LITERAL1
PIX_CAPACITOR_POL	LITERAL1
PIX_DIODE	LITERAL1
PIX_ZENER	LITERAL1
PIX_TRANSISTOR	LITERAL1
PIX_FUSE	LITERAL1
PIX_INDUCTOR	LITERAL1
PIX_SWITCH	LITERAL1
PIX_SQUARE_WAVE	LITERAL1
PIX_TRIANGLE_WAVE	LITERAL1
PIX_SAWTOOTH_WAVE	LITERAL1
PIX_SINE_WAVE	LITERAL1
PIX_DC	LITERAL1
PIX_ARDUINO	LITERAL1

PIX_PLAY	LITERAL1
PIX_PAUSE	LITERAL1
PIX_FORWARD	LITERAL1
PIX_REVERSE	LITERAL1
PIX_SKIP_FORWARD	LITERAL1
PIX_SKIP_BACK	LITERAL1

PIX_DICE_1	LITERAL1
PIX_DICE_2	LITERAL1
PIX_DICE_3	LITERAL1
PIX_DICE_4	LITERAL1
PIX_DICE_5	LITERAL1
PIX_DICE_6	LITERAL1

PIX_RAIN	LITERAL1
PIX_SNOW	LITERAL1
PIX_SUNNY	LITERAL1
PIX_CLOUDY	LITERAL1
PIX_WINDY	LITERAL1
PIX_MOON	LITERAL1

PIX_D_QUOTE_LEFT	LITERAL1
PIX_D_QUOTE_RIGHT	LITERAL1
PIX_D_QUOTE_RIGHT_2	LITERAL1
PIX_D_QUOTE_L_UNDER	LITERAL1
PIX_D_QUOTE_R_UNDER	LITERAL1
PIX_QUOTE_LEFT	LITERAL1
PIX_QUOTE_RIGHT	LITERAL1
PIX_QUOTE_RIGHT_2	LITERAL1
PIX_QUOTE_L_UNDER	LITERAL1
PIX_QUOTE_R_UNDER	LITERAL1
PIX_ANGLE_QUOTE_L	LITERAL1
PIX_ANGLE_QUOTE_R	LITERAL1
PIX_DEGREES	LITERAL1
PIX_BITCOIN	LITERAL1
PIX_CENTS	LITERAL1
PIX_EURO	LITERAL1
PIX_GBP	LITERAL1
PIX_YUAN	LITERAL1
PIX_RMB	LITERAL1
PIX_JPY	LITERAL1
PIX_TRY	LITERAL1
PIX_CHF	LITERAL1
PIX_RUB	LITERAL1
PIX_INR	LITERAL1
PIX_MICRO	LITERAL1
PIX_PI	LITERAL1
PIX_COPYRIGHT	LITERAL1
PIX_ELLIPSIS	LITERAL1

PIX_A_ACUTE	LITERAL1
PIX_A_CEDILLA	LITERAL1
PIX_A_CIRCUMFLEX	LITERAL1
PIX_A_GRAVE	LITERAL1
PIX_A_MACRON	LITERAL1
PIX_A_OVERDOT	LITERAL1
PIX_A_TILDE	LITERAL1
PIX_A_UMLAUT	LITERAL1
PIX_E_ACUTE	LITERAL1
PIX_E_CEDILLA	LITERAL1
PIX_E_CIRCUMFLEX	LITERAL1
PIX_E_GRAVE	LITERAL1
PIX_E_MACRON	LITERAL1
PIX_E_UMLAUT	LITERAL1
PIX_I_ACUTE	LITERAL1
PIX_I_CIRCUMFLEX	LITERAL1
PIX_I_GRAVE	LITERAL1
PIX_I_MACRON	LITERAL1
PIX_I_UMLAUT	LITERAL1
PIX_O_ACUTE	LITERAL1
PIX_O_CIRCUMFLEX	LITERAL1
PIX_O_GRAVE	LITERAL1
PIX_O_MACRON	LITERAL1
PIX_O_TILDE	LITERAL1
PIX_O_UMLAUT	LITERAL1
PIX_U_ACUTE	LITERAL1
PIX_U_CIRCUMFLEX	LITERAL1
PIX_U_GRAVE	LITERAL1
PIX_U_MACRON	LITERAL1
PIX_U_UMLAUT	LITERAL1
PIX_C_ACUTE	LITERAL1
PIX_C_CARON	LITERAL1
PIX_C_CEDILLA	LITERAL1
PIX_L_CEDILLA	LITERAL1
PIX_N_ACUTE	LITERAL1
PIX_N_CEDILLA	LITERAL1
PIX_N_TILDE	LITERAL1
PIX_S_ACUTE	LITERAL1
PIX_S_CARON	LITERAL1
PIX_Y_UMLAUT	LITERAL1
PIX_Z_ACUTE	LITERAL1
PIX_Z_CARON	LITERAL1
PIX_Z_OVERDOT	LITERAL1

PIX_ESZETT	LITERAL1

PIX_L_SLAVIC	LITERAL1

PIX_ETH_UPPER	LITERAL1
PIX_ETH_LOWER	LITERAL1
PIX_THORN	LITERAL1